################################
#....#.........#...............# 
#....#.................#.......# 
#....#.........####.####..SS...# 
#....#.........#.......#..SS...# 
#....######.####.......#.......# 
#....#....#.#..........#.......# 
#....#....#.#..........####.#### 
#.........#.#..................# 
#....#....#.######.##..........# 
#....#....#.#.......#..........# 
#....#....#.#.......#..........# 
#....#....#.#.......#..........# 
#....#....#.####.#########.....# 
#....######..............#.....# 
#.........#..............#.....# 
#.........###########.####.....# 
#..............................# 
#..............................# 
#..............................# 
#..............................# 
####.######.#######.##.....##### 
#.........#.#........#.....#...# 
#.........#..........#.....#...# 
#.........#.#........#.........# 
#.........#.#........#.....#...# 
#..SS.......#........#.....#...# 
#..SS.....#.#........#.....#...# 
#.........#.#........#.....#...# 
######.####.##############.##### 
#..............................# 
################################
